领料分包	推车	设备	
收省拼侧片	拖轮平缝车	设备		
分侧缝粘前袖弯	烫台	设备	
拉前袖笼沙牵带	拉牵带机	设备	
前片推门	烫台	设备	
肩缝抛醋酸脂	平车	设备	
劈手巾袋	台板	设备			
扣手巾袋	烫台	设备	
机开手巾袋	开手巾袋机	设备	
分烫手巾袋	烫台	设备	
装手巾袋布	平车	设备		
封手巾袋外口,暗撬手巾袋	手巾袋机	设备	
劈袋盖	台板	设备	
割袋盖	割袋盖机	设备	
反烫大袋盖,修烫大袋盖	烫袋盖机	设备
机开大袋	开袋机	设备	
剪,反烫大袋嵌	袋嵌线烫机	设备	
装大袋布,辑袋贴	平车	设备	
打大袋套节	套节车	设备	
叠,切胸衬	三角针车	设备	
复扎胸衬	扎线车	设备		
烫驳口牵带	烫台	设备		
中间压烫	前身定型烫机	设备			
撬驳头牵带,拆驳口扎线	撬边车	设备	
修剪胸衬	台板	设备		
拼挂面与前片里子,拼侧片	平车	设备	
烫挂面,里侧片缝	烫台	设备	
定里袋位	台板	设备	
粘里,卡袋嵌线	烫台	设备	
机开里袋卡袋	开袋机	设备	
剪,烫里卡袋嵌	烫台	设备	
烫三角	烫台	设备	
打三角眼	平头锁眼车	设备	
钉商标	三角针车	设备	
辑里袋贴,装里袋布	平车	设备	
烫里袋布	烫台	设备	
撬里袋布	撬边车	设备	
里袋打套节	套节机	设备	
复挂面,钉肩棉	扎线车	设备	
扎驳头	台板	设备	
夹止口拆扎线	割止口车	设备	
止口检查	台板	设备	
修剪止口内缝	台板	设备	
分止口内缝,止口翻出	专用烫台	设备	
烫外止口,对长短	烫台	设备	
撩缝	撩缝车	设备
扎成品挂面	扎线车	设备	
对号上吊挂	吊挂系统	设备	
几切被缝	长缝车	设备	
拉后袖龙牵带	平车	设备		
归烫后背	烫台	设备	
拉后领圈牵带	平车	设备	
辑里被缝	平车	设备	
拷面子摆缝	拖轮链条车	设备	
烫面摆缝,背逢	背摆缝烫机	设备	
拷里摆缝	平车	设备	
烫里背摆缝,烫面底边	烫台	设备	
拷面肩缝	平车	设备	
分烫肩缝	肩缝烫机	设备		
扎领圈	扎线车	设备	
劈领脚	平车	设备	
合领面	平车	设备	
分烫领脚线	烫台	设备	
辑领底呢脚线	融袖车	设备	
合领	三角针车	设备	
夹领脚	平车	设备	
反烫成品领	烫台	设备	
划领串口	台板	设备		
划挂面串口,装领,剪领脚	平车	设备	
分烫串口,粘侧面串口	烫台	设备	
辑领底呢	三角针车	设备		
拷里肩缝,拼上部位挂面和里子	平车	设备	
粘烫领串口驳头	摇臂烫台	设备	
扎上部位挂面	扎线车	设备	
压领脚线	珠边车	设备	
撬挂面	撬边车	设备	
辑底边扎缝	平车	设备	
撬底边	撬边车	设备	
中段检查	车架	设备		
划袖叉,袖眼,打袖眼	袖叉眼机	设备	
拔大袖片瘪缝	拔内袖缝机	设备	
辑修叉三角	拖轮平缝车	设备	
辑袖瘪缝	专用车	设备	
烫袖瘪缝,烫袖口贴边,修剪修叉角	烫台	设备	
辑小修叉,袖口定位,拼大小袖胖缝	平车	设备		
分烫袖胖缝	分烫外袖缝机	设备	
钉袖口钮	自动钉扣机	设备	
拼大小袖里子	平车	设备	
烫袖里子	烫台	设备		
套面,里袖口,摘缝	平车	设备		
撬袖口贴边	撬边车	设备	
袖子面,里摘缝	平车	设备	
烫成品袖	袖口定型机	设备	
装袖面	上袖机	设备	
袖子检查	车架	设备	
烫里底边	烫台	设备	
扎袖笼	烫袖底机	设备	
叠,做弹袖衬	融袖机	设备	
装弹袖衬	平车	设备	
扎前袖笼	扎线车	设备	
剪,分烫修山头	分烫外袖机	设备	
捋肩头	高头扎线车	设备	
合肩棉,合袖龙面里子	切割肩棉车	设备	
上袖里子	上夹里机	设备		
封袖口	平车	设备		
撬领角	手工	设备	
拆全件线头	车架	设备	
半成品检验	车架	设备	
划眼位	台板	设备	
锁眼	圆头锁眼机	设备	
锁插花眼	圆头锁眼机	设备	
打套节	套节车	设备	
钉吊标	套节车	设备		
点钮位	台板	设备	
剪,刷线头	车架	设备
整烫	烫台	设备
	